%%%%%%%%%%%%
%.        .%
%.%% %%.%% %
%G        P%
% %%.%% %%.%
%.        .%
%%%%%%%%%%%%
