%%%%%%%%%
%.  .  .%
%.%%%%%.%
%G%   %P%
%.%%%%%.%
%.  .  .%
%%%%%%%%%
