%%%%%%%%%%
%........%
%.%%%%%%.%
%G%    %P%
%.%%%%%%.%
%........%
%%%%%%%%%%
