%%%%%%%%%%%
%.........%
%.%%%%%%%.%
%G%     %P%
%.%%%%%%%.%
%.........%
%%%%%%%%%%%
