%%%%%%%%%%
%.  ..  .%
%.%%%%%%.%
%G%    %P%
%.%%%%%%.%
%.  ..  .%
%%%%%%%%%%
