%%%%%%%%%%
%.  ..  .%
% %%%%%% %
%G%    %P%
% %%%%%% %
%.  ..  .%
%%%%%%%%%%
