%%%%%%%%%%
%.       %
% %%%%%% %
%G%    %P%
% %%%%%% %
%       .%
%%%%%%%%%%
