%%%%%%%%%
%.  .  .%
% %%%%% %
%G%   %P%
% %%%%% %
%.  .  .%
%%%%%%%%%
