%%%%%%%%%
%.. . ..%
%.%%%%%.%
%G%   %P%
%.%%%%%.%
%.. . ..%
%%%%%%%%%
