%%%%%%%%%%
%.. .....%
%.%%%%%%.%
%G%    %P%
%.%%%%%%.%
%..... ..%
%%%%%%%%%%
