%%%%%%%%%
%.     .%
% %%%%% %
%G%   %P%
% %%%%% %
%.     .%
%%%%%%%%%
