%%%%%%%
%    P% 
% %.% %  
%G    % 
%%%%%%%
