%%%%%%%%%%%%
%..........%
%.%% %%.%% %
%G        P%
% %%.%% %%.%
%..........%
%%%%%%%%%%%%
