%%%%%%%%%%%%
%..........%
%.%% %%.%% %
%         P%
% %%.%% %%.%
%..........%
%%%%%%%%%%%%
