%%%%%%%
%....P% 
%.%%%.%  
%G....% 
%%%%%%%
