%%%%%%%%%
%.......%
%.%%.%%.%
%      P%
%.%%.%% %
%.......%
%%%%%%%%%
