%%%%%%%%%
%.......%
%.%% %%.%
%G     P%
% %%.%% %
%.......%
%%%%%%%%%
