%%%%%%%%%
%......P% 
%.%% %%.%  
%G......% 
%%%%%%%%%
