%%%%%%%%%
%.     P% 
% %% %% %  
%G     .% 
%%%%%%%%%
