%%%%%%%%%
%.  .  .%
%.%% %%.%
%G     P%
% %%.%% %
%.  .  .%
%%%%%%%%%
