%%%%%%%%%%%%
%..........%
%.%% %%.%% %
%     P    %
% %%.%% %%.%
%..........%
%%%%%%%%%%%%
