%%%%%%%%%
%.......%
%.%% %%.%
%      P%
% %%.%% %
%.......%
%%%%%%%%%
