%%%%%%%%%
%.......%
%.%%.%%.%
%      P%
%.%%.%%.%
%.......%
%%%%%%%%%
