%%%%%%%%%
%.......%
%.%%.%%.%
%      P%
% %%.%% %
%.......%
%%%%%%%%%
